1 1 1 1 1 1 1 1 1 1 1 1 1 1 1 1 1
1 1 1 1 1 1 1 1 1 1 1 1 1 1 1 1 1
1 1 1 1 1 1 1 1 1 1 1 1 1 1 1 1 1
8 8 8 8 8 8 8 8 8 8 8 8 8 8 8 8 8
9 9 9 9 9 9 9 9 10 9 9 9 9 9 9 9 9
7 7 7 7 7 7 7 12 0 11 7 7 7 7 7 7 7
1 1 1 1 1 1 1 3 0 2 4 1 1 1 1 1 1
1 1 1 1 1 1 1 3 0 2 1 1 1 1 1 1 1
1 1 1 1 1 1 1 3 0 2 1 1 1 1 1 1 1
1 1 1 1 1 1 1 3 0 2 1 1 1 1 1 1 1
1 1 1 1 1 1 1 3 0 2 1 1 1 1 1 1 1
1 1 1 1 1 1 1 3 0 2 1 1 1 1 1 1 1
1 1 1 1 1 1 1 3 0 2 1 1 1 1 1 1 1
1 1 1 1 1 1 1 3 0 2 1 1 1 1 1 1 1
1 1 1 1 1 1 1 3 0 2 1 1 1 1 1 1 1